#nama provinsi=singkatan satu kata
Nanggroe Aceh Darussalam=NAD
Sumatera Utara=Sumut
Sumatera Barat=Sumbar
Bengkulu=Bengkulu
Riau=Riau
Kepulauan Riau=Kepri
Jambi=Jambi
Sumatera Selatan=Sumsel
Lampung=Lampung
Kepulauan Bangka Belitung=Babel
DKI Jakarta=Jakarta
Jawa Barat=Jabar
Banten=Banten
Jawa Tengah=Jateng
DI Yogyakarta=DIY
Jawa Timur=Jatim
Kalimantan Barat=Kalbar
Kalimantan Tengah=Kalteng
Kalimantan Selatan=Kalsel
Kalimantan Timur=Kaltim
Kalimantan Utara=Kaltara
Bali=Bali
Nusa Tenggara Barat=NTB
Nusa Tenggara Timur=NTT
Sulawesi Barat=Sulbar
Sulawesi Utara=Sulut
Sulawesi Tengah=Sulteng
Sulawesi Selatan=Sulsel
Sulawesi Tenggara=Sultra
Gorontalo=Gorontalo
Maluku=Maluku
Maluku Utara=Malut
Papua Barat=Papbar
Papua=Papua
Luar Negri=LN